=3333333333333333A
4-22222222222222BL
45+111111111111CKL
456U...........JKL
456.P.T....O...JKL
456.........P..JKL
456.d....P.....JKL
456...P......D.JKL
456T.....U.....JKL
456....D....P..JKL
456..O.........JKL
456............JKL
456..P...T...P.JKL
456.U..P....dO.JKL
456X........T..JKL
45)777777777777:KL
\(88888888888888;\
